60      1
180     0
300     1
420     2
540     1
600     3