60      2
120     0
180     1
240     2
300     0
360     1
420     2
500     3